11111111111111111111
10100000000011111101
10101111111000000001
10101000000011111101
10001011111111111101
11101011111111111101
10001000000000000001
10101011101011111101
10101011101011111101
10101000000000000001
10101010101010110101
10000000000000000101
11111010111011111101
10000000000000000001
11111111111111111111
